23220000044440000000
23220000044440220000
23204440044440204400
23004440000000004400
23000000000000020011
23004400244400200111
23204402244402201111
03220000000220011111
03011111111111111110
11111111111111111100
11111111111111111200
11111000002000002000
03220000004440003300
03244000004440003444
03244000000220000444
03300002200000044330
03330000244000244300
33300044044344333000
33344444033344330023
33344433333333334433


















